10x10
WW WWWWWWW
WP  >     
W> p   V W
W  R  V  W
W  >    RW
W   G<   W
W  ^  <  W
W ^  D L W
    U   <W
WWWWWWW WW