10x10
WW WWWWWWW
W   >  G  
W> p P V W
W  R pV  W
W  > p  pW
W    p   W
W p^ D   W
W D    L W
        <W
WWWWWWW WW