10x10
WW WWWWWWW
W   >     
W> p   V W
W  R  V  W
W  >    RW
W   G<  P W
W  ^  <p W
W ^  D L W
    W   <W
WWWWWWW WW