10x10
WW WWWWWWW
WP  >     
W>     V W
W     V  W
W  >     W
W   G<   W
W  ^  <  W
W ^      W
        <W
WWWWWWW WW