10x10
grass
W,W, ,W,W,W,W,W,W,W
W, , , ,>, , ,G, , 
W,>, ,p, ,P, ,V, ,W
W, , ,r, ,p,V, , ,W
W, , ,>, ,p, ,<,p,W
W, , , , ,p, , , ,W
W, ,p,^, ,d, , , ,W
W, ,d, , , , ,l, ,W
 , , , , , , , ,<,W
W,W,W,W,W,W,W, ,W,W