10x10
WWWWWWWWWW
WP       W
W        W
W   p    W
W        W
W     p  W
W        W
W G      W
W       GW
WWWWWWWWWW