10x10
grass
W,W, ,W,W,W,W,W,W,W
W, , , ,>, , ,G, , 
W,>, ,p, ,P, ,V, ,W
W, , ,R, ,p,V, , ,W
W, , ,>, ,p, , ,p,W
W, , , , ,p, , , ,W
W, ,p,^, ,D, , , ,W
W, ,D, , , , ,L, ,W
 , , , , , , , ,<,W
W,W,W,W,W,W,W, ,W,W