8x8
WWWWWWWW
WP     W
W W  W W
W      W
W      W
W W  W W
W      W
WWWWWWWW