7x6
grass
W,W, W,W, W,W,W
W,P,  , ,D1, ,W
W, ,B1, , W, ,W
W, , p, , W, ,W
W, ,  , , W,G,W
W,W, W,W, W,W,W