14x10
sea
W,W,W,W,W,W,W,W,W,W,W,W,W,W
W, , , , , , , , , , , , ,W
W, ,p, ,>, ,p, , , , , , ,W
W, ,p, ,R, ,p, , , , , , ,W
W, , , , , , , ,G, , , , ,W
W, ,p, ,>,p, , ,P,p,R,D, ,W
W, ,p, ,R,p, , , , ,U,L, ,W
W, , , , , , , , , , , , ,W
W, , , , , , , , , , , , ,W
W,W,W,W,W,W,W,W,W,W,W,W,W,W