8x7
sea
W, W,W, W,W,W,W,W
W, P, ,D1, , ,G,W
W, p,W, W,W,W,W,W
W, r,r, r,r,r,d,W
W, W,W, W,W,W,d,W
W,B1,l, l,l,l,l,W
W, W,W, W,W,W,W,W