8x6
WWWWWWWW
WP     W
W  p p W
W  p p W
W      W
WWWWWWWW