8x6
WWWWWWWW
WP     W
W>Vp p W
W^<p p W
W      W
WWWWWWWW