14x10
sea
W,W,W,W,W,W,W,W,W,W,W,W,W,W
W, , , , , , , , , , , , ,W
W, ,p, ,>, ,p, , , , ,D, ,W
W, ,p, ,R, ,p, , , , ,D, ,W
W, , , , , , , ,G, , ,D, ,W
W, ,p, ,>,p, , ,P,p,R,D, ,W
W, ,p, ,R,p, , , , ,U,L, ,W
W, , , , , , , , , , , , ,W
W, , , , , , , , , , , , ,W
W,W,W,W,W,W,W,W,W,W,W,W,W,W