10x10
WWWWWWWWWW
WP       W
W p > p  W
W p R p  W
W        W
W p >p   W
W p Rp   W
W        W
W        W
WWWWWWWWWW