14x10
sea
WWWWWWWWWWWWWW
W            W
W p > p      W
W p R p      W
W            W
W p >p  PpRD W
W p Rp    UL W
W            W
W            W
WWWWWWWWWWWWWW