13x5
sea
W,W, W, W, W, W, W, W, W, W, W,W,W
W, ,D1,D2,D3,D4,D5,D6,D7,D8,D9, ,W
W,P,B1,B2,B3,B4,B5,B6,B7,B8,B9,G,W
W, ,D9,D8,D7,D6,D5,D4,D3,D2,D1, ,W
W,W, W, W, W, W, W, W, W, W, W,W,W